+ +-+-+-+-+
| |       |
+ + + + + +
| |       |
+ + + + + +
| |       |
+ + + + + +
| |       |
+ +-+-+-+ +
|        S|
+-+-+-+-+-+
