+-+-+-+-+-+-+
|S      |   |
+ +-+-+ +-+ +
|     |     |
+ +-+ + +-+-+
|     |     |
+-+ +-+ + + +
| |     | | |
+ +-+ +-+ +-+
|   | |     |
+-+ + + +-+-+
|            
+-+-+-+-+-+-+
